07 07 07 07 07 07 07 07 07 07 07 07 07 07 07 07 07 07 07 07 07 07 07 07 07 07 07 07 07 07 07 07 07 07 07 07 07 07 07 07 07 07 07 07 07 07 07 07 07 07 07 07 07 07 07 07 07 07 07 07
07 07 07 07 07 07 07 07 07 07 07 07 07 07 07 07 07 07 07 07 07 07 07 07 07 07 07 07 07 07 07 07 07 07 07 07 07 07 07 07 07 07 07 07 07 07 07 07 07 07 07 07 07 07 07 07 07 07 07 07
07 07 07 07 07 07 07 07 07 07 07 07 07 07 07 07 07 07 07 07 07 07 07 07 07 07 07 07 07 07 07 07 07 07 07 07 07 07 07 07 07 07 07 07 07 07 07 07 07 07 07 07 07 07 07 07 07 07 07 07
07 07 07 07 07 07 07 07 07 07 07 07 07 07 07 07 07 07 07 07 07 07 07 07 07 07 07 07 07 07 07 07 07 07 07 07 07 07 07 07 07 07 07 07 07 07 07 07 07 07 07 07 07 07 07 07 07 07 07 07
07 07 07 07 07 07 07 07 07 07 07 07 07 07 07 07 07 07 07 07 07 07 07 07 07 07 07 07 07 07 07 07 07 07 07 07 07 07 07 07 07 07 07 07 07 07 07 07 07 07 07 07 07 07 07 07 07 07 07 07
07 07 07 07 07 07 07 07 07 07 07 07 07 07 07 07 07 07 07 07 07 07 07 07 07 07 07 07 07 07 07 07 07 07 07 07 07 07 07 07 07 07 07 07 07 07 07 07 07 07 07 07 07 07 07 07 07 07 07 07
07 07 07 07 07 07 07 07 07 07 07 07 07 07 07 07 07 07 07 07 07 07 07 07 07 07 07 07 07 07 07 07 07 07 07 07 07 07 07 07 07 07 07 07 07 07 07 07 07 07 07 07 07 07 07 07 07 07 07 07
07 07 07 07 07 07 07 07 07 07 07 07 07 01 01 01 01 01 01 01 01 01 01 01 01 01 07 07 07 07 07 07 07 07 07 07 07 07 07 07 07 07 07 07 07 07 07 07 07 07 07 07 07 07 07 07 07 07 07 07
07 07 07 07 07 07 07 07 07 07 07 01 01 01 01 01 01 01 01 01 01 01 03 23 01 01 07 07 07 07 07 07 07 07 07 07 07 07 07 07 07 07 07 07 07 07 07 07 07 07 07 07 07 07 07 07 07 07 07 07
07 07 07 07 07 07 07 07 07 07 07 01 01 01 01 01 01 01 01 01 01 01 01 02 01 01 07 07 07 07 07 07 07 07 07 07 07 07 07 07 07 07 07 07 07 07 07 07 07 07 07 07 07 07 07 07 07 07 07 07
07 07 07 07 07 07 07 07 07 07 07 01 01 01 01 01 01 01 01 01 01 01 01 02 01 01 01 01 01 01 01 01 01 01 01 01 07 07 07 07 07 07 07 07 07 07 07 07 07 07 07 07 07 07 07 07 07 07 07 07
07 07 07 07 07 07 07 07 07 07 07 07 07 07 07 07 01 01 01 01 01 01 01 02 01 01 01 01 01 01 01 01 01 01 01 01 07 07 07 07 07 07 07 07 07 07 07 07 07 07 07 07 07 01 01 07 07 07 07 07
07 07 07 07 07 07 07 07 07 07 07 07 07 07 07 07 01 01 22 03 03 03 03 25 03 03 03 03 03 03 03 03 03 23 01 01 07 07 07 07 07 07 07 07 07 07 07 07 07 07 07 07 01 01 01 07 07 07 07 07
07 07 07 07 07 07 07 07 07 07 07 07 07 07 07 07 01 01 02 01 01 01 01 01 01 01 01 01 01 01 01 01 01 02 01 01 01 01 01 01 01 01 01 01 01 01 01 01 01 01 01 01 01 01 01 07 07 07 07 07
07 07 07 07 07 07 01 01 01 01 01 01 01 01 01 01 01 01 02 01 01 01 01 01 01 01 01 01 01 01 01 01 01 21 03 03 23 01 01 01 01 01 01 01 01 01 01 01 01 01 01 01 01 01 01 07 07 07 07 07
07 07 07 07 07 07 01 01 01 01 01 01 01 01 01 01 01 01 02 01 01 01 01 01 01 01 01 01 01 01 01 01 01 01 01 01 02 01 01 01 01 01 01 01 01 01 01 01 01 01 01 01 01 01 01 07 07 07 07 07
07 07 07 07 07 07 07 01 01 22 03 03 03 24 03 03 03 03 20 01 01 01 01 01 01 01 01 01 01 01 01 01 01 01 01 01 02 01 01 01 01 01 01 01 01 01 01 01 01 01 01 01 01 01 01 07 07 07 07 07
07 07 07 07 07 07 07 01 01 02 01 01 01 02 01 01 01 01 01 01 01 01 01 01 01 01 01 01 01 01 01 01 01 01 01 01 02 01 01 01 01 01 01 01 01 01 01 01 01 01 01 01 01 01 01 07 07 07 07 07
07 07 07 07 07 07 07 01 01 01 01 01 01 02 01 01 01 01 01 01 01 01 01 07 07 07 07 07 07 07 01 01 01 01 01 01 02 01 01 01 01 01 01 01 01 01 01 01 01 01 01 01 01 01 01 07 07 07 07 07
07 07 07 07 07 07 07 01 01 01 01 01 01 02 01 01 01 01 01 01 01 01 01 07 07 07 07 07 07 07 01 01 01 01 01 01 02 01 01 01 01 01 01 01 01 01 01 01 01 01 01 01 01 01 01 07 07 07 07 07
07 07 07 07 07 07 07 07 07 07 07 01 01 02 01 01 01 01 07 07 07 07 07 07 07 07 07 07 07 07 01 01 01 01 01 01 02 01 01 01 01 01 01 01 01 01 01 01 01 01 01 01 01 01 01 07 07 07 07 07
07 07 07 07 07 07 07 07 07 07 07 01 01 02 01 01 01 01 07 07 07 07 07 07 07 07 07 07 07 07 07 01 01 01 01 01 02 01 01 01 01 01 01 01 01 01 01 01 01 01 01 01 01 01 01 07 07 07 07 07
07 07 07 07 07 07 07 07 07 07 07 01 01 02 01 01 01 01 07 07 07 07 07 07 07 07 07 07 07 07 07 01 01 22 03 03 25 03 03 03 03 03 03 03 03 03 03 03 03 03 03 03 03 03 03 07 07 07 07 07
07 07 07 07 07 07 07 07 07 07 07 01 01 02 01 01 01 01 07 07 07 07 07 07 07 07 07 07 07 07 07 01 01 02 01 01 01 01 01 01 01 01 01 01 01 01 01 01 01 01 01 01 01 01 01 07 07 07 07 07
07 07 07 07 07 07 07 07 07 07 07 01 01 02 01 01 01 01 01 01 01 01 07 07 07 07 07 07 07 07 07 01 01 02 01 01 01 01 01 01 01 01 01 01 01 01 01 01 01 01 01 01 01 01 01 07 07 07 07 07
07 07 07 07 07 07 07 07 01 01 01 01 01 21 03 03 03 03 03 23 01 01 07 07 07 07 07 07 07 07 07 01 01 02 01 01 01 01 01 01 01 01 01 01 01 01 01 01 01 01 01 01 01 01 01 07 07 07 07 07
07 07 07 07 07 07 07 07 01 01 01 01 01 01 01 01 01 01 01 02 01 01 07 07 07 07 07 07 07 07 07 01 01 02 01 01 01 01 01 01 01 01 01 01 01 01 01 01 01 01 01 01 01 01 01 07 07 07 07 07
07 07 07 07 07 07 07 07 01 01 01 01 01 01 01 01 01 01 01 02 01 01 07 07 07 07 07 01 01 01 01 01 01 02 01 01 01 01 01 01 01 01 01 01 01 01 01 01 01 01 01 01 01 01 01 07 07 07 07 07
07 07 07 07 07 07 07 07 01 01 01 01 01 01 01 01 01 01 01 02 01 01 07 07 07 07 07 01 01 01 01 01 01 02 01 07 07 07 07 07 07 07 07 07 01 01 01 01 01 01 01 01 01 01 01 07 07 07 07 07
07 07 07 07 07 07 07 07 07 07 07 07 07 01 01 01 01 01 01 02 01 01 01 01 07 07 07 01 01 01 01 01 01 02 01 07 07 07 07 07 07 07 07 07 01 01 01 01 01 01 01 01 01 01 01 07 07 07 07 07
07 07 07 07 07 07 07 07 07 07 07 07 07 01 01 01 01 01 01 02 01 01 01 01 01 01 01 01 01 01 01 01 01 02 01 07 07 07 07 07 07 07 07 07 07 07 07 07 07 07 07 07 07 07 01 07 07 07 07 07
07 07 07 07 07 07 07 07 07 07 07 07 07 01 01 01 01 22 03 25 03 03 03 03 03 03 03 03 03 03 03 03 03 20 01 07 07 07 07 07 07 07 07 07 07 07 07 07 07 07 07 07 07 07 07 07 07 07 07 07
07 07 07 07 07 07 07 07 07 07 07 07 07 01 01 01 01 02 01 01 01 01 01 01 01 01 01 01 01 01 01 01 01 01 01 07 07 07 07 07 07 07 07 07 07 07 07 07 07 07 07 07 07 07 07 07 07 07 07 07
07 07 07 07 07 07 07 07 07 07 07 07 07 01 01 01 01 02 01 01 01 01 01 01 01 01 01 01 01 01 01 01 01 01 01 07 07 07 07 07 07 07 07 07 07 07 07 07 07 07 07 07 07 07 07 07 07 07 07 07
07 07 07 07 07 07 01 01 01 01 07 07 07 01 01 01 01 02 01 01 01 01 01 01 01 01 07 07 07 07 07 07 07 07 07 07 07 07 07 07 01 01 01 01 01 01 01 01 01 01 01 01 07 07 07 07 07 07 07 07
07 07 07 07 07 07 01 01 01 01 07 07 07 01 01 01 01 02 01 01 01 01 01 01 01 01 07 07 07 07 07 07 07 07 07 07 07 07 07 07 01 01 01 01 01 01 01 01 01 01 01 01 07 07 07 07 07 07 07 07
07 07 07 07 07 07 01 01 01 01 07 07 07 01 01 01 01 02 01 01 01 07 07 07 07 07 07 07 07 07 07 07 07 07 07 07 07 07 07 07 01 01 01 01 01 01 01 01 01 01 01 01 01 01 01 07 07 07 07 07
07 07 07 07 07 07 01 01 01 01 07 07 07 01 01 01 01 02 01 01 01 07 07 07 07 07 07 07 07 07 07 07 07 07 07 07 07 07 07 07 01 01 01 01 01 01 01 01 01 01 01 01 01 01 01 07 07 07 07 07
07 07 07 07 07 07 01 01 01 01 01 01 01 01 01 01 01 02 01 01 01 07 07 07 07 07 07 07 07 07 07 07 07 07 01 01 01 01 01 01 01 01 01 01 01 01 01 01 01 01 01 01 01 01 01 07 07 07 07 07
07 07 07 07 07 07 07 07 07 01 01 22 03 03 03 03 03 20 01 01 01 07 07 07 07 07 07 07 07 07 07 07 07 07 01 01 01 01 01 01 01 01 01 01 01 01 01 01 01 01 01 01 01 01 01 07 07 07 07 07
07 07 07 07 07 07 07 07 07 01 01 02 01 01 01 01 01 01 01 01 01 07 07 07 07 07 07 07 07 07 01 01 01 01 01 01 01 01 01 01 01 01 01 01 01 01 01 01 01 01 01 01 01 01 01 07 07 07 07 07
07 07 07 07 07 07 07 07 07 01 01 02 01 01 01 01 01 01 01 01 01 07 07 07 07 07 07 07 07 07 01 01 01 01 01 01 01 01 01 01 01 01 01 01 01 01 01 01 01 01 01 01 01 01 01 07 07 07 07 07
07 07 07 07 07 07 07 07 07 01 01 02 01 07 07 07 07 07 01 01 01 07 07 07 07 07 07 07 07 07 01 01 01 01 01 01 01 01 01 01 01 01 01 01 01 01 01 01 01 01 01 01 01 01 01 07 07 07 07 07
07 07 07 07 07 07 07 07 07 01 01 02 01 07 07 07 07 07 01 01 01 01 01 01 07 07 07 07 07 07 01 01 01 01 01 01 01 01 01 01 01 01 01 01 01 01 01 01 01 01 01 01 01 01 01 07 07 07 07 07
07 07 07 07 07 07 07 07 07 01 01 02 01 07 07 07 07 07 01 01 01 01 01 01 07 07 07 07 07 07 01 01 01 01 01 01 01 01 01 01 01 01 01 01 01 01 01 01 01 01 01 01 01 01 01 07 07 07 07 07
07 07 07 07 07 07 07 07 07 01 01 02 01 07 07 07 07 01 01 01 01 01 01 01 07 07 07 07 07 07 01 01 01 01 01 01 01 01 01 01 01 01 01 01 01 01 01 01 01 01 01 01 01 01 01 07 07 07 07 07
07 07 07 07 07 07 07 07 07 01 01 02 01 01 01 01 01 01 01 01 01 02 01 01 07 07 07 07 07 07 01 01 01 01 01 01 01 01 01 01 01 01 01 01 01 01 01 01 01 01 01 01 01 01 01 07 07 07 07 07
07 07 07 07 07 07 07 07 07 01 22 25 03 03 03 03 03 03 03 03 03 20 01 01 07 07 07 07 07 07 01 01 01 01 01 01 01 01 01 01 01 01 01 01 01 01 01 01 01 01 01 01 01 01 01 07 07 07 07 07
07 07 07 07 07 07 07 07 07 01 02 01 01 01 01 01 01 01 01 01 01 01 01 01 07 07 07 07 07 07 07 07 07 01 01 01 01 01 01 01 01 01 01 01 01 01 01 01 01 01 01 01 01 01 01 07 07 07 07 07
07 07 07 07 07 07 07 01 01 01 02 01 01 01 01 01 01 01 01 01 01 01 01 01 07 07 07 07 07 07 07 07 07 01 01 01 01 01 01 01 01 01 01 01 01 01 01 01 01 01 01 01 01 01 01 07 07 07 07 07
07 07 07 07 07 07 07 01 01 01 02 01 07 07 07 07 07 01 01 01 01 01 01 01 01 07 07 07 07 07 07 07 07 01 01 01 01 01 01 01 01 01 01 01 01 01 01 01 01 01 01 01 01 01 01 07 07 07 07 07
07 07 07 07 07 07 07 01 01 01 02 01 07 07 07 07 07 01 01 01 01 01 01 01 01 07 07 07 07 07 07 07 07 07 01 01 01 01 01 01 01 01 01 01 01 01 01 01 01 01 01 01 01 01 01 07 07 07 07 07
07 07 07 07 07 07 07 01 01 01 01 01 07 07 07 01 01 01 01 01 01 01 01 01 01 07 07 07 07 07 07 07 07 07 01 01 01 01 01 01 01 07 07 07 07 07 07 01 01 01 01 01 01 01 01 07 07 07 07 07
07 07 07 07 07 07 07 07 07 07 07 07 07 07 07 01 01 01 01 01 01 01 01 01 01 07 07 07 07 07 07 07 07 07 07 07 07 07 07 07 07 07 07 07 07 07 07 01 01 01 01 01 01 01 01 07 07 07 07 07
07 07 07 07 07 07 07 07 07 07 07 07 07 07 07 07 07 07 07 07 07 07 07 07 07 07 07 07 07 07 07 07 07 07 07 07 07 07 07 07 07 07 07 07 07 07 07 01 01 01 01 01 01 01 01 07 07 07 07 07
07 07 07 07 07 07 07 07 07 07 07 07 07 07 07 07 07 07 07 07 07 07 07 07 07 07 07 07 07 07 07 07 07 07 07 07 07 07 07 07 07 07 07 07 07 07 07 07 07 07 07 07 07 07 07 07 07 07 07 07
07 07 07 07 07 07 07 07 07 07 07 07 07 07 07 07 07 07 07 07 07 07 07 07 07 07 07 07 07 07 07 07 07 07 07 07 07 07 07 07 07 07 07 07 07 07 07 07 07 07 07 07 07 07 07 07 07 07 07 07
07 07 07 07 07 07 07 07 07 07 07 07 07 07 07 07 07 07 07 07 07 07 07 07 07 07 07 07 07 07 07 07 07 07 07 07 07 07 07 07 07 07 07 07 07 07 07 07 07 07 07 07 07 07 07 07 07 07 07 07
07 07 07 07 07 07 07 07 07 07 07 07 07 07 07 07 07 07 07 07 07 07 07 07 07 07 07 07 07 07 07 07 07 07 07 07 07 07 07 07 07 07 07 07 07 07 07 07 07 07 07 07 07 07 07 07 07 07 07 07
07 07 07 07 07 07 07 07 07 07 07 07 07 07 07 07 07 07 07 07 07 07 07 07 07 07 07 07 07 07 07 07 07 07 07 07 07 07 07 07 07 07 07 07 07 07 07 07 07 07 07 07 07 07 07 07 07 07 07 07




