00 00 00 00 00 00 00 00 00 00 00 00 00 00 00 00 00 00 00 00 00 00 00 00 00 00 00 00 00 00 00 00 00 00 00 00 00 00 00 00 00 00 00 00 00 00 00 00 00 00 00 00 00 00 00 00 00 00 00 00
00 00 00 00 00 00 00 00 00 00 00 00 00 00 00 00 00 00 00 00 00 00 00 00 00 00 00 00 00 00 00 00 00 00 00 00 00 00 00 00 00 00 00 00 00 00 00 00 00 00 00 00 00 00 00 00 00 00 00 00
00 00 00 00 00 00 00 00 00 00 00 00 00 00 00 00 00 00 00 00 00 00 00 00 00 00 00 00 00 00 00 00 00 00 00 00 00 00 00 00 00 00 00 00 00 00 00 00 00 00 00 00 00 00 00 00 00 00 00 00
00 00 00 00 00 00 00 00 00 00 00 00 00 00 00 00 00 00 00 00 00 00 00 00 00 00 00 00 00 00 00 00 00 00 00 00 00 00 00 00 00 00 00 00 00 00 00 00 00 00 00 00 00 00 00 00 00 00 00 00
00 00 00 00 00 00 00 00 00 00 00 00 00 00 00 00 00 00 00 00 00 00 00 00 00 00 00 00 00 00 00 00 00 00 00 00 00 00 00 00 00 00 00 00 00 00 00 00 00 00 00 00 00 00 00 00 00 00 00 00
00 00 00 00 00 00 00 00 00 00 00 00 00 00 00 00 00 00 00 00 00 00 00 00 00 00 00 00 00 00 00 00 00 00 00 00 00 00 00 00 00 00 00 00 00 00 00 00 00 00 00 00 00 00 00 00 00 00 00 00
00 00 00 00 00 00 00 00 00 00 00 00 15 13 13 13 13 13 13 13 13 13 13 13 13 13 14 00 00 00 00 00 00 00 00 00 00 00 00 00 00 00 00 00 00 00 00 00 00 00 00 00 00 00 00 00 00 00 00 00
00 00 00 00 00 00 00 00 00 00 15 13 16 51 51 51 51 00 00 00 00 00 00 00 00 00 08 00 00 00 00 00 00 00 00 00 00 00 00 00 00 00 00 00 00 00 00 00 00 00 00 00 00 00 00 00 00 00 00 00
00 00 00 00 00 00 00 00 00 00 09 51 51 00 00 56 00 00 00 00 00 00 00 00 00 00 08 00 00 00 00 00 00 00 00 00 00 00 00 00 00 00 00 00 00 00 00 00 00 00 00 00 00 00 00 00 00 00 00 00
00 00 00 00 00 00 00 00 00 00 09 00 00 56 00 00 00 00 51 52 56 00 00 00 00 00 17 13 13 13 13 13 13 13 13 13 14 00 00 00 00 00 00 00 00 00 00 00 00 00 00 00 00 00 00 00 00 00 00 00
00 00 00 00 00 00 00 00 00 00 09 00 55 00 00 00 00 00 52 53 55 00 00 00 56 51 55 00 00 00 00 56 58 58 58 58 08 00 00 00 00 00 00 00 00 00 00 00 00 00 00 00 15 13 13 00 00 00 00 00
00 00 00 00 00 00 00 00 00 00 12 10 10 10 10 18 00 00 00 00 00 00 00 00 00 00 00 00 00 00 00 00 00 00 56 58 08 00 00 00 00 00 00 00 00 00 00 00 00 00 00 15 16 51 51 00 00 00 00 00
00 00 00 00 00 00 00 00 00 00 00 00 00 00 00 09 00 51 00 00 00 00 00 00 00 00 00 00 00 00 00 00 00 00 00 56 17 13 13 13 13 13 13 13 13 13 13 13 13 13 13 16 51 51 51 00 00 00 00 00
00 00 00 00 00 15 13 13 13 13 13 13 13 13 13 16 55 56 00 00 00 00 00 00 00 51 56 00 00 00 00 00 00 00 00 00 00 00 00 00 00 00 51 51 51 51 51 51 51 51 51 51 51 51 51 00 00 00 00 00
00 00 00 00 00 09 00 00 51 56 00 00 00 51 56 00 00 00 00 00 00 00 51 00 56 52 55 00 00 00 00 00 00 00 00 00 00 00 00 00 00 00 00 57 51 51 51 51 51 51 51 51 51 51 51 00 00 00 00 00
00 00 00 00 00 09 00 00 00 00 00 00 00 53 00 51 56 00 00 00 00 00 00 00 00 00 00 51 00 00 00 00 51 52 00 00 00 00 55 00 00 56 00 00 00 51 51 51 51 51 51 51 51 51 51 00 00 00 00 00
00 00 00 00 00 12 18 00 00 00 00 00 00 00 00 00 00 00 00 00 51 00 56 00 51 00 00 00 00 00 56 00 55 56 00 00 00 00 00 00 00 00 00 00 00 00 00 51 51 51 51 51 51 51 51 00 00 00 00 00
00 00 00 00 00 00 09 51 56 00 00 00 00 00 00 00 00 56 00 00 56 00 00 00 53 00 51 51 51 51 57 00 00 00 51 00 00 00 00 00 00 53 00 00 00 56 00 00 51 51 51 51 51 51 51 00 00 00 00 00
00 00 00 00 00 00 09 55 52 00 00 57 00 00 00 00 00 00 00 00 00 53 00 19 10 10 10 10 10 18 51 56 00 55 53 56 00 00 00 00 00 00 56 00 00 00 00 00 00 51 51 51 51 51 51 00 00 00 00 00
00 00 00 00 00 00 09 00 00 00 00 00 00 00 00 58 56 00 51 51 51 51 57 08 00 00 00 00 00 09 51 00 00 00 00 00 00 00 58 54 00 00 00 00 51 00 00 00 00 00 00 51 51 51 51 00 00 00 00 00
00 00 00 00 00 00 12 10 10 10 18 53 00 00 00 55 00 51 19 10 10 10 10 11 00 00 00 00 00 09 00 00 00 51 00 00 00 00 00 00 56 00 00 51 55 52 00 00 00 00 00 00 00 00 00 00 00 00 00 00
00 00 00 00 00 00 00 00 00 00 09 58 00 00 00 00 00 51 08 00 00 00 00 00 00 00 00 00 00 12 18 00 00 00 00 00 00 00 00 00 00 00 00 00 00 00 56 00 00 00 00 00 00 00 00 00 00 00 00 00
00 00 00 00 00 00 00 00 00 00 09 58 56 00 00 00 00 00 08 00 00 00 00 00 00 00 00 00 00 00 09 00 00 00 00 00 00 00 00 00 00 00 00 00 00 00 00 00 00 00 00 00 00 00 00 00 00 00 00 00
00 00 00 00 00 00 00 00 00 00 09 58 53 00 00 00 51 56 17 13 13 13 14 00 00 00 00 00 00 00 09 00 51 00 00 00 00 00 00 00 53 56 00 00 00 00 00 00 00 00 00 00 56 00 00 00 00 00 00 00
00 00 00 00 00 00 00 15 13 13 16 56 00 00 00 56 00 55 00 00 58 58 08 00 00 00 00 00 00 00 09 00 00 00 00 55 58 00 00 56 00 00 00 53 00 58 00 00 56 00 00 00 00 00 00 00 00 00 00 00
00 00 00 00 00 00 00 09 57 56 00 00 00 00 00 00 00 00 00 00 56 58 08 00 00 00 00 00 00 00 09 00 00 00 00 00 00 00 00 00 00 00 00 56 00 00 52 00 00 00 51 51 51 51 51 00 00 00 00 00
00 00 00 00 00 00 00 09 56 00 00 00 00 00 00 00 52 56 00 00 00 58 08 00 00 00 15 13 13 13 16 51 58 00 00 00 00 55 53 00 00 00 00 00 00 00 56 00 51 51 51 51 51 51 51 00 00 00 00 00
00 00 00 00 00 00 00 09 00 51 51 51 51 00 00 57 56 00 52 00 00 00 08 00 00 00 09 00 00 00 00 53 55 00 00 00 00 53 51 57 56 00 00 51 51 51 51 51 51 51 51 51 51 51 51 00 00 00 00 00
00 00 00 00 00 00 00 09 51 51 51 51 51 51 00 00 00 53 00 00 00 51 17 13 14 00 09 00 51 53 00 00 00 00 00 19 10 10 10 10 10 10 10 18 51 51 51 51 51 51 51 51 51 51 51 00 00 00 00 00
00 00 00 00 00 00 00 12 10 10 10 10 18 51 51 00 52 00 00 00 00 55 53 58 17 13 16 00 56 57 00 51 00 00 00 08 00 00 00 00 00 00 00 09 51 51 51 51 51 51 51 51 51 51 51 00 00 00 00 00
00 00 00 00 00 00 00 00 00 00 00 00 09 51 51 00 00 00 00 00 00 00 00 56 58 58 56 00 00 00 00 00 00 00 00 08 00 00 00 00 00 00 00 12 10 10 10 10 10 10 10 10 10 18 51 00 00 00 00 00
00 00 00 00 00 00 00 00 00 00 00 00 09 51 51 00 00 00 00 00 00 00 00 00 00 00 00 00 00 00 00 00 00 00 00 08 00 00 00 00 00 00 00 00 00 00 00 00 00 00 00 00 00 12 10 00 00 00 00 00
00 00 00 00 00 00 00 00 00 00 00 00 09 51 51 00 00 00 00 56 00 00 00 00 00 00 58 56 00 51 00 00 00 00 51 08 00 00 00 00 00 00 00 00 00 00 00 00 00 00 00 00 00 00 00 00 00 00 00 00
00 00 00 00 00 15 13 13 13 13 14 00 09 51 51 00 00 00 00 54 56 00 00 00 00 00 00 00 00 53 55 00 51 00 00 08 00 00 00 15 13 13 13 13 13 13 13 13 13 13 13 13 14 00 00 00 00 00 00 00
00 00 00 00 00 09 57 00 51 56 08 00 09 51 51 00 00 00 00 00 00 51 51 51 51 00 19 10 10 10 10 10 10 10 10 11 00 00 00 09 00 00 00 00 00 00 00 00 00 00 00 00 08 00 00 00 00 00 00 00
00 00 00 00 00 09 00 00 55 00 08 00 09 51 00 00 00 00 56 00 51 51 51 51 51 51 08 00 00 00 00 00 00 00 00 00 00 00 00 09 00 00 00 00 00 00 00 00 00 00 00 00 17 13 13 00 00 00 00 00
00 00 00 00 00 09 51 56 00 00 08 00 09 51 00 00 00 00 00 51 51 19 10 10 10 10 11 00 00 00 00 00 00 00 00 00 00 00 00 09 00 00 00 00 00 00 00 00 00 00 00 00 00 00 00 00 00 00 00 00
00 00 00 00 00 09 00 00 00 00 17 13 16 00 00 58 00 00 00 51 51 08 00 00 00 00 00 00 00 00 00 00 00 15 13 13 13 13 13 16 00 00 00 00 00 00 00 00 00 00 00 00 00 00 00 00 00 00 00 00
00 00 00 00 00 09 00 00 00 00 00 00 00 00 00 00 55 00 00 51 51 08 00 00 00 00 00 00 00 00 00 00 00 09 00 00 00 00 00 00 00 00 00 00 00 00 00 00 00 00 00 00 00 00 00 00 00 00 00 00
00 00 00 00 00 12 10 10 18 00 00 00 00 00 00 00 00 00 00 51 51 08 00 00 00 00 00 00 00 15 13 13 13 16 00 00 00 00 00 00 00 00 00 00 00 00 00 00 00 00 00 00 00 00 00 00 00 00 00 00
00 00 00 00 00 00 00 00 09 00 00 00 00 00 51 56 00 00 00 00 51 08 00 00 00 00 00 00 00 09 00 00 00 00 00 00 00 00 00 00 00 00 00 00 00 00 00 00 00 00 00 00 00 00 00 00 00 00 00 00
00 00 00 00 00 00 00 00 09 51 56 00 00 00 56 57 00 00 00 00 51 08 00 00 00 00 00 00 00 09 00 00 00 00 00 00 00 00 00 00 00 00 00 00 00 00 00 00 00 00 00 00 00 00 00 00 00 00 00 00
00 00 00 00 00 00 00 00 09 00 00 00 00 19 10 10 10 18 00 00 51 17 13 13 14 00 00 00 00 09 00 00 00 00 00 00 00 00 00 00 00 00 00 00 00 00 00 00 00 00 00 00 00 00 00 00 00 00 00 00
00 00 00 00 00 00 00 00 09 00 00 00 00 08 00 00 00 09 00 00 00 51 51 51 08 00 00 00 00 09 00 00 00 00 00 00 00 00 00 00 00 00 00 00 00 00 00 00 00 00 00 00 00 00 00 00 00 00 00 00
00 00 00 00 00 00 00 00 09 58 52 00 00 08 00 00 15 16 00 00 00 00 00 51 08 00 00 00 00 09 00 00 00 00 00 00 00 00 00 00 00 00 00 00 00 00 00 00 00 00 00 00 00 00 00 00 00 00 00 00
00 00 00 00 00 00 00 00 09 55 53 00 00 17 13 13 16 00 51 58 00 00 00 51 08 00 00 00 00 09 00 00 00 00 00 00 00 00 00 00 00 00 00 00 00 00 00 00 00 00 00 00 00 00 00 00 00 00 00 00
00 00 00 00 00 00 00 00 09 00 00 00 00 00 56 00 56 00 00 55 00 00 00 51 08 00 00 00 00 09 00 00 00 00 00 00 00 00 00 00 00 00 00 00 00 00 00 00 00 00 00 00 00 00 00 00 00 00 00 00
00 00 00 00 00 00 00 00 09 00 00 00 00 00 00 00 00 00 00 00 00 00 00 51 08 00 00 00 00 09 00 00 00 00 00 00 00 00 00 00 00 00 00 00 00 00 00 00 00 00 00 00 00 00 00 00 00 00 00 00
00 00 00 00 00 00 15 13 16 00 00 00 00 00 00 56 00 00 00 00 00 00 00 00 08 00 00 00 00 12 10 10 18 00 00 00 00 00 00 00 00 00 00 00 00 00 00 00 00 00 00 00 00 00 00 00 00 00 00 00
00 00 00 00 00 00 09 00 00 00 00 56 51 51 51 51 51 56 00 00 51 00 00 00 17 14 00 00 00 00 00 00 09 00 00 00 00 00 00 00 00 00 00 00 00 00 00 00 00 00 00 00 00 00 00 00 00 00 00 00
00 00 00 00 00 00 09 00 51 56 00 51 19 10 10 10 18 51 00 00 00 51 53 00 00 08 00 00 00 00 00 00 09 00 00 00 00 00 00 00 00 00 00 00 00 00 00 00 00 00 00 00 00 00 00 00 00 00 00 00
00 00 00 00 00 00 09 00 00 54 00 00 08 00 15 13 16 00 51 00 00 53 00 00 00 08 00 00 00 00 00 00 12 18 00 00 00 00 00 00 00 00 00 00 00 00 00 00 00 00 00 00 00 00 00 00 00 00 00 00
00 00 00 00 00 00 09 51 56 00 00 00 08 00 09 57 00 00 52 54 00 56 00 00 00 08 00 00 00 00 00 00 00 09 00 00 00 00 00 00 00 19 10 10 10 10 18 00 00 00 00 00 00 00 00 00 00 00 00 00
00 00 00 00 00 00 12 10 10 10 10 10 11 00 09 00 56 00 00 00 00 00 00 57 00 08 00 00 00 00 00 00 00 12 10 10 10 10 10 10 10 11 00 00 00 00 09 00 00 00 00 00 00 00 00 00 00 00 00 00
00 00 00 00 00 00 00 00 00 00 00 00 00 00 12 10 10 10 10 10 10 10 10 10 10 11 00 00 00 00 00 00 00 00 00 00 00 00 00 00 00 00 00 00 00 00 09 00 00 00 00 00 00 00 00 00 00 00 00 00
00 00 00 00 00 00 00 00 00 00 00 00 00 00 00 00 00 00 00 00 00 00 00 00 00 00 00 00 00 00 00 00 00 00 00 00 00 00 00 00 00 00 00 00 00 00 00 00 00 00 00 00 00 00 00 00 00 00 00 00
00 00 00 00 00 00 00 00 00 00 00 00 00 00 00 00 00 00 00 00 00 00 00 00 00 00 00 00 00 00 00 00 00 00 00 00 00 00 00 00 00 00 00 00 00 00 00 00 00 00 00 00 00 00 00 00 00 00 00 00
00 00 00 00 00 00 00 00 00 00 00 00 00 00 00 00 00 00 00 00 00 00 00 00 00 00 00 00 00 00 00 00 00 00 00 00 00 00 00 00 00 00 00 00 00 00 00 00 00 00 00 00 00 00 00 00 00 00 00 00
00 00 00 00 00 00 00 00 00 00 00 00 00 00 00 00 00 00 00 00 00 00 00 00 00 00 00 00 00 00 00 00 00 00 00 00 00 00 00 00 00 00 00 00 00 00 00 00 00 00 00 00 00 00 00 00 00 00 00 00
00 00 00 00 00 00 00 00 00 00 00 00 00 00 00 00 00 00 00 00 00 00 00 00 00 00 00 00 00 00 00 00 00 00 00 00 00 00 00 00 00 00 00 00 00 00 00 00 00 00 00 00 00 00 00 00 00 00 00 00




